Mikołaj Krzysztoporski	>> Mikołaj Krzysztoporski - polski poeta. Syn Jana Krzysztoporskiego. 	1				
Stanisław Bereś	>> null	0				
Charles Lindbergh	>> Charles Lindbergh - amerykański pionier lotnictwa, wsławiony pierwszym samolotowym samotnym przelotem między lądem Ameryki Północnej a Europą bez międzylądowań w 1927, generał brygady US Army, doktor honoris causa Uniwersytetu Illinois i innych uczelni. 	1				
Paweł Hertz	>> Paweł Hertz - polski pisarz, poeta, tłumacz i wydawca. 	1				Ruollah Chomejni
John Maynard Keynes	>> John Maynard Keynes - angielski ekonomista, twórca teorii interwencjonizmu państwowego w dziedzinie ekonomii i finansów państwowych. Był synem logika i ekonomisty Johna Neville’a Keynesa  i Ady Florence Keynes z domu Brown  brytyjskiej pisarki. 	1				
Adam Wiśniewski-Snerg	>> Adam Wiśniewski-Snerg - polski pisarz science fiction. Jedna z najbardziej zagadkowych postaci literatury polskiej XX wieku. 	1				
Emmeline Pankhurst	>> Emmeline Pankhurst - brytyjska działaczka społeczna, jedna z założycielek brytyjskiego ruchu sufrażystek, najważniejsza angielska działaczka na rzecz przyznania kobietom praw wyborczych przed I wojną światową. 	1				
Marek Nowakowski	>> Marek Nowakowski - polski pisarz, przedstawiciel małego realizmu, publicysta, scenarzysta. 	1				
Stanisław Miłaszewski	>> Stanisław Miłaszewski - polski dramatopisarz, publicysta, poeta i tłumacz, senator II RP, urzędnik Wydziału Teatru w Ministerstwie Sztuki i Kultury w 1919 roku. 	1				
Bohdan Czeszko	>> Bohdan Czeszko - polski pisarz, scenarzysta i publicysta, poseł na Sejm PRL IV, V, VI i VII kadencji, członek egzekutywy POP PZPR przy Zarządzie Głównym Związku Literatów Polskich na początku lat 50. 	1				
Maria Nurowska	>> Maria Nurowska - polska powieściopisarka i nowelistka. Jej dziadek był arystokratą, ojciec legionistą, matka należała do Armii Krajowej. 	1				
Hugo Kołłątaj	>> null	0				
Wincenty Pol	>> null	0				
Igor Strawinski	>> null	0				
Janusz Głowacki	>> Janusz Głowacki - polski prozaik, dramaturg, scenarzysta, felietonista i eseista. 	1				
Bob Dylan	>> Bob Dylan - amerykański piosenkarz, kompozytor, autor tekstów, pisarz i poeta, laureat Nagrody Nobla w dziedzinie literatury w roku 2016. Jest jedną z najważniejszych postaci muzyki popularnej ostatnich pięciu dekad. 	1				
Jacek Piekara	">> Jacek Piekara - polski pisarz fantasy, dziennikarz i redaktor czasopism o grach komputerowych , a także redaktor naczelny czasopisma ""Fantasy"". Studiował psychologię i prawo na Uniwersytecie Warszawskim. "	1				
Władysław Bełza	>> Władysław Bełza - polski poeta neoromantyczny, piszący w duchu patriotycznym, nazywany piewcą polskości. Publicysta, animator życia kulturalnego, oświatowego i prasowego. 	1				
Bruno Kiciński	>> null	0				
Lucjan Rudnicki	>> null	0				
Bracia Wright	>> Bracia Wright - amerykańscy pionierzy lotnictwa. Uważani są powszechnie za konstruktorów pierwszego udanego samolotu. 	1				
Adolf Nowaczyński	>> Adolf Nowaczyński - polski pisarz, dramaturg, satyryk, poeta, publicysta, eseista, krytyk, działacz polityczny i społeczny. Używał przydomku Neuwert; pseudonimów: Adolf Neuwert, Adolf Przyjaciel, Anecki N., Antisperanto, Artur Amis, Clarus, Clarus Adolf, Halban, Junius, Mścisław Kamień Młyński, Nova, Paweł Turbia Wiewiórski, Przyjaciel, Sowizdrzał i kryptonimów: a , a. n. , A. 	1				
Andrzej Sarwa	>> null	0				
Aleksander Fredro	>> Aleksander Fredro - polski komediopisarz, pamiętnikarz, poeta, wolnomularz, tworzył w epoce romantyzmu. 	1				
Szymon Starowolski	>> Szymon Starowolski - polihistor, preceptor w domach magnackich I Rzeczypospolitej, ksiądz katolicki, kantor tarnowski, kanonik krakowski, polski historyk i pisarz polityczny epoki baroku, kaznodzieja. 	1				
Mirosław Nahacz	>> Mirosław Nahacz - polski pisarz, scenarzysta. Studiował kulturoznawstwo na Uniwersytecie Warszawskim. 	1				
Rafał Ziemkiewicz	>> Rafał Ziemkiewicz - polski dziennikarz, publicysta, komentator polityczny i ekonomiczny, pisarz fantastycznonaukowy i działacz fandomu. Współzałożyciel stowarzyszenia Endecja. 	1				
Władysław Sebyła	>> Władysław Sebyła - polski poeta, podporucznik rezerwy piechoty Wojska Polskiego, ofiara zbrodni katyńskiej. 	1				
Włodzimierz Lenin	>> null	0				
Ewa Felińska	>> Ewa Felińska - uczestniczka spisków niepodległościowych, zesłanka, autorka powieści obyczajowych i wspomnień z zesłania, matka Zygmunta Szczęsnego  przyszłego arcybiskupa warszawskiego. 	1				
Władysław Jabłonowski	>> Nie wiem kto to jest Władysław Jabłonowski.	0				
Maria Krzymuska Iwanowska	>> Nie wiem kto to jest Maria Krzymuska Iwanowska.	0				
Jan Ostroróg	>> Nie wiem kto to jest Jan Ostroróg.	0				
Jan Lam	">> Jan Lam - polski powieściopisarz, satyryk, redaktor ""Dziennika Polskiego"", nauczyciel. "	0				
Igor Newerly	>> Igor Newerly - polski pisarz i pedagog. 	1				
Karol Antoniewicz	>> Karol Antoniewicz - polski duchowny katolicki, jezuita, poeta. 	1				
Władysław Broniewski	>> Władysław Broniewski - polski poeta, przedstawiciel liryki rewolucyjnej, tłumacz; żołnierz Legionów Polskich, uczestnik wojny polsko-bolszewickiej. 	1				
Bruce Lee	>> null	0				
Teofil Budzanowski	>> null	0				
Peggy Whitson	>> Peggy Whitson - doktor biochemii, amerykańska astronautka. Pierwsza kobieta, która dowodziła Międzynarodową Stacją Kosmiczną . 	1				
Izabela Sowa	>> Izabela Sowa - polska pisarka. 	1				
Roman Zmorski	>> Roman Zmorski - polski poeta, tłumacz i folklorysta epoki romantyzmu, najwybitniejszy przedstawiciel tzw. Cyganerii Warszawskiej; autor liryki ludowej silnie związanej z tradycją Mazowsza oraz ideami panslawizmu. 	1				
Philo Farnsworth	>> null	0				
Moon Jae-in	>> Moon Jae-in - południowokoreański polityk i prawnik. Od 10 maja 2017 prezydent Republiki Korei. 	1				
Ludwig Wittgenstein	>> Ludwig Wittgenstein - filozof zajmujący się przede wszystkim kwestiami języka i logiki, poruszał także kwestie kluczowe dla filozofii umysłu i matematyki. Jego wczesne prace uczyniły z niego „ojca chrzestnego” neopozytywizmu, późniejsze natomiast stanowiły kluczowy wkład w badaniach nad pragmatyką. 	1				
Stanisława Fleszarowa Muskat	>> Nie wiem kto to jest Stanisława Fleszarowa Muskat.	0				
Karol Miarka	>> null	0				
Bogusław Butrymowicz	>> Bogusław Butrymowicz - polski poeta okresu Młodej Polski, tłumacz i historyk literatury. Absolwent Gimnazjum im. 	1				
Jan Chryzostom Pasek	>> Jan Chryzostom Pasek - marszałek sejmiku rawskiego w 1661 roku, komornik ziemi krakowskiej, polski pamiętnikarz epoki baroku. 	1				
Mikołaj Łęczycki	>> null	0				
Tadeusz Różewicz	>> Tadeusz Różewicz - polski poeta, dramaturg, prozaik i scenarzysta, członek Wydziału VI Twórczości Artystycznej Polskiej Akademii Umiejętności; brat Janusza i Stanisława, ojciec Jana oraz Kamila. 	1				
Józef Czechowicz	>> Nie wiem kto to jest Józef Czechowicz.	0				
Adam Ważyk	>> Adam Ważyk - polski poeta, prozaik, eseista, tłumacz pochodzenia żydowskiego. Brat Leona Trystana i Samuela Wagmana. 	1				
Kazimierz Przerwa Tetmajer	>> Nie wiem kto to jest Kazimierz Przerwa Tetmajer.	0				
Dominik Rudnicki	>> Dominik Rudnicki - polski poeta, jezuita. 	1				
Krzysztof Szatrawski	>> Krzysztof Szatrawski - polski poeta, prozaik, krytyk muzyczny i literacki. 	1				
Francis Crick	>> Francis Crick - angielski biochemik, genetyk i biolog molekularny, laureat Nagrody Nobla w dziedzinie fizjologii lub medycyny w roku 1962. Wraz z Jamesem D. 	1				
Joanna Siedlecka	>> Joanna Siedlecka - polska eseistka, reportażystka. 	1				
Katarzyna Grochola	>> Katarzyna Grochola - polska pisarka i dziennikarka. 	1				
Tomasz Jastrun	>> null	0				
Emilia Eysymont	">> Emilia Eysymont - poetka, pisarka, współpracowniczka warszawskich ""Kłosów"". "	1				
Jacek Dehnel	>> Jacek Dehnel - polski pisarz, tłumacz, malarz. 	1				
James Joyce	>> James Joyce - irlandzki pisarz tworzący w języku angielskim, jeden z najwybitniejszych pisarzy XX wieku. 	1				
Zygmunt Kisielewski	>> Zygmunt Kisielewski - polski pisarz, brat Jana Augusta, ojciec Stefana. Był synem Augusta i Józefy z Szałajków. 	1				
Józef Weyssenhoff	>> Nie wiem kto to jest Józef Weyssenhoff.	0				
Teresa Bogusławska	>> null	0				
Zofia Wójcicka Chylewska	>> Nie wiem kto to jest Zofia Wójcicka Chylewska.	0				
Feliks Gwiżdż	>> Feliks Gwiżdż - legionista, kapitan rezerwy piechoty Wojska Polskiego, dziennikarz, pisarz, poeta, tłumacz, poseł II i III kadencji oraz senator IV kadencji w II RP. 	1				
Józef Bohdan Dziekoński	>> Józef Bohdan Dziekoński - polski prozaik epoki romantyzmu; znany z burzliwego życia oraz tajemniczej osobowości autor „opowieści niesamowitych”. W znacznej mierze inspirowane hoffmannowskim obliczem literatury grozy oraz mistyką chrześcijańską, nowele Dziekońskiego skupiały się na sferze zmagań duchowych bohaterów bez reszty zaangażowanych w „poszukiwanie absolutu prawdy”, wiecznej miłości oraz realizacji metafizycznych tęsknot. 	1				
Jerzy Stanisław Dzieduszycki	>> Jerzy Stanisław Dzieduszycki - pisarz polityczny, koniuszy wielki koronny, historyk, bibliofil i kolekcjoner. 	1				
Stanisław Herakliusz Lubomirski	>> Stanisław Herakliusz Lubomirski - polski magnat , podstoli koronny , marszałek wielki koronny w latach 16761702, marszałek nadworny koronny 16731676, starosta spiski ; poeta tzw. baroku dworskiego , mecenas sztuki. 	1				
Mieczysław Srokowski	>> Mieczysław Srokowski - polski pisarz i poeta. 	1				
Mikołaj Rej	>> Mikołaj Rej - polski poeta i prozaik renesansowy, tłumacz, a także polityk i teolog ewangelicki, wójt urzędowski, poseł na Sejm I Rzeczypospolitej. Choć nie był humanistą w naukowym rozumieniu tego słowa, zawdzięcza się mu upowszechnienie idei humanitas w polskiej kulturze. 	1				
Jacek Salij	>> null	0				
Louis Armstrong	>> Louis Armstrong - amerykański trębacz i wokalista jazzowy. Wyróżniał się stylem gry na trąbce i wokalistyką jazzową, do której wprowadził śpiew scatem. 	1				
Gabriela Zapolska	>> null	0				
Józef Łobodowski	>> Józef Łobodowski - współczesny polski poeta, autor liryki głęboko wizyjnej, proroczej i patetycznej, prozaik, publicysta, tłumacz. Publikował pod pseudonimami: Krawczenko, Maiński, Marienholz, Pszonka, Stefan Kuryłło, Szperacz. 	1				
Narcyza Żmichowska	>> null	0				
Stanisław Orzechowski	>> Nie wiem kto to jest Stanisław Orzechowski.	0				
Stanisław Wyrzykowski	>> Stanisław Wyrzykowski - polski poeta, powieściopisarz i tłumacz okresu Młodej Polski, blisko współpracujący z krakowskim „Życiem” i warszawską „Chimerą”, kierownik Wydziału Teatru w Ministerstwie Sztuki i Kultury w 1919 roku. Początkowo pisał wiersze nastrojowo-opisowe, łączące w sobie typowe wątki myślowe modernistów. 	1				
Władysław Orkan	>> null	0				
Antoni Lange	>> Antoni Lange - polski poeta, tłumacz, filozof-mistyk, poliglota, krytyk literacki, dramatopisarz, powieściopisarz i lewicowy publicysta pochodzenia żydowskiego, zaliczany do pierwszego pokolenia poetów Młodej Polski. Przez pewien czas również redaktor warszawskiego „Życia”. 	1				
Karol Irzykowski	>> Karol Irzykowski - polski krytyk literacki i filmowy, poeta, prozaik, dramaturg, teoretyk filmu, tłumacz, szachista. 	1				
Martin Luther King	>> null	0				
Zygmunt Różycki	>> Zygmunt Różycki - polski poeta. Był synem Jana Różyckiego h. 	1				
Lucjan Rydel	>> Nie wiem kto to jest Lucjan Rydel.	0				
Lucille Ball	>> Lucille Ball - amerykańska aktorka. 	1				
Stanisław Tarło	>> Nie wiem kto to jest Stanisław Tarło.	0				
Amadeo Giannini	>> Amadeo Giannini - amerykański bankier, założyciel Bank of America. Urodził się w rodzinie emigrantów z Sardynii. 	1				
Ruollah Chomeini	>> OK	1				
